WWWWWWWWWWWWWWWWWWWW
WWWWWWWWWWWWWWWWWWWW
WWWWWWSSSSWWWWWWWWWW
WWWWWWSSSSSSSWWWWWWW
WWWWWWSSTSSSSSSWWWWW
WWWWWSSSTTTSSSSSWWWW
WWWWSSSSTTTTTTSSWWWW
WWWWSSSTTTTTTTSSWWWW
WWWSSSTTTTTTTTSSWWWW
WWSSSTTTTTTTTTSSSWWW
WWSSTTTTTTTTTTTSSSWW
WWSSSTTTTTTTTTSSSSWW
WWSSSSTTTTTTTTSSSSWW
WWWSSSTTTTTTTSSSSWWW
WWWWWSSSSSSSSSSSSWWW
WWWWWSSSSSSSSSSSSWWW
WWWWWSSSSSWWWWWWWWWW
WWWWWWWWWWWWWWWWWWWW
WWWWWWWWWWWWWWWWWWWW
WWWWWWWWWWWWWWWWWWWW
