WWWWWWWWWWWWWWWWWWWWWWWWWWWWWW
WWWWWWWWWWWWWSSSSWWWWWWWWWWWWW
WWWWWSSSSSSSSSSSSWWWWWWWWWWWWW
WWWWWSSDDDSSGGGGSSSWWWWWWWWWWW
WWWWWSSDDDDDSSGGGGSSSSSWWWWWWW
WWWWWSSDTTTDDDDDGGGSSSSSSSWWWW
WWWWSSDDTTTTTTTDDDGSSSSSSSWWWW
WWWSSDDTTTTTTTDDDGGSSSSWWWWWWW
WWWSDDTTTTTTTTTTDDGSSSSWWWWWWW
WWSSDTTTTTTTTTTTTDGSSSWWWWWWWW
WWSSDTTTTTTTTTDDDDGGSSSWWWWWWW
WWSSDTTTTTTTTDDDSGGGGGSSWWWWWW
WWSSDDDTTTTTTDDSSSSSSSSSSSSWWW
WWWSSSSSSSSSSSSSSSSSWWWSSSSSWW
WWWWWWWWWWWWWWWWWWWWWWWWWWWWWW
